0 0 0 0 0 0 0 0 1 1 0 0 0 0 0 0 0 0 0 0 0 0 0 0 0 0 0 0 0
0 0 0 0 0 0 0 0 1 1 0 0 0 0 0 0 0 0 0 0 0 0 0 0 0 0 0 0 0
0 0 0 0 0 0 0 0 1 1 0 0 0 0 0 0 0 0 0 0 0 0 0 6 0 0 0 0 0
0 5 0 0 0 0 0 0 1 1 0 0 0 0 2 0 0 7 0 0 2 2 2 4 4 2 2 0 0
2 2 2 2 2 0 0 0 1 1 0 0 0 0 0 0 0 0 0 0 0 1 1 1 1 1 1 0 0
0 0 0 0 0 0 0 0 1 1 2 0 0 0 0 0 0 0 0 0 0 1 0 0 0 0 0 0 0
0 0 0 0 0 8 0 0 1 1 0 0 3 0 0 0 0 0 0 0 0 1 0 0 0 0 0 0 0
0 0 0 0 0 0 0 0 1 1 2 2 2 2 2 0 0 0 0 0 0 1 0 0 0 0 0 0 0
0 0 0 0 0 0 0 0 0 0 0 0 0 0 0 0 2 0 0 0 0 1 0 0 0 0 0 0 0
0 0 0 2 0 0 0 0 0 0 0 0 0 0 0 0 0 0 0 0 0 1 0 0 0 0 0 0 0
2 0 0 0 0 0 2 0 0 0 0 0 0 0 0 0 0 0 6 0 2 1 0 0 0 0 0 0 0
0 0 0 0 6 0 0 0 2 2 0 0 0 0 0 0 0 0 0 0 0 1 0 0 0 3 0 0 6
0 0 0 0 0 0 0 0 1 1 0 0 0 0 0 0 0 3 0 0 0 1 0 0 4 2 2 2 2
0 0 2 0 0 0 0 0 1 1 0 0 0 2 0 0 0 2 0 0 0 1 0 0 1 1 0 0 0
0 0 0 0 0 0 0 0 1 1 0 0 0 1 0 0 0 0 0 0 0 1 0 0 0 0 0 0 0
0 0 0 0 2 0 0 0 1 1 0 9 0 1 0 0 0 0 0 0 0 1 0 0 0 0 0 6 0
0 0 0 0 0 0 0 0 1 1 0 2 0 1 0 0 6 0 0 0 2 1 8 0 0 0 0 0 0
0 0 0 0 0 0 0 2 1 1 0 0 0 1 0 0 0 0 0 0 0 1 0 0 0 0 0 0 0
0 0 10 0 0 0 0 0 1 1 0 0 0 1 0 0 0 0 0 0 0 1 0 0 0 0 0 0 0
0 0 0 0 0 3 0 0 1 1 0 0 0 1 0 0 2 8 0 0 0 1 0 0 3 0 0 9 0
2 2 2 4 4 2 4 2 1 1 4 4 4 1 4 4 4 4 4 4 4 1 4 4 2 2 2 2 2
1 1 1 1 1 1 1 1 1 1 1 1 1 1 1 1 1 1 1 1 1 1 1 1 1 1 1 1 1